%%%%%%%%%%%%%%%%%%%%%%%%%%%
%o..G....................o%
%.%%%.%.%%%%%.%.%%%.%.%.%.%
%.......%%%%%.............%
%.%%%.%.%%%%%.%.%%%.%.%%%.%
%.%%%...........%.....G...%
%.%%%%%.%%%%%.%.%.%.%.%%%.%
%.%%%%%.%%%%%.%.%.%.%.%%%.%
%.%%%%%.%%%%%.%.%.%.%.%%%.%
%.%%%%%.%.................%
%.%%%%%.%.%%%.%.%.%.%%%%%.%
%.........................%
%.%%%%%.%.%%%.%.%.%.%%%%%.%
%.%%%%%.%.%.%.%.%.%.%%%%%.%
%.%%%%%.%.%.%.%.%.%.%%%%%.%
%...P...........%.%.%%%%%.%
%.%%%%%.%.%.%.%%%.%.%%%%%.%
%.........%.%.%%%.%.%%%%%.%
%.%%%%%.%%%.%.%%%.%.%%%%%.%
%o%%%%%..................o%
%%%%%%%%%%%%%%%%%%%%%%%%%%%
%%%%%%%%%%%%%%%%%%%%%%%%%%%
