%%%%%%%%%%%%%%%%%%%%%%%%%%
%o...................o%%%%
%.%%%%%%%.%.%%%%%%%...%%%%
%.....................%%%%
%....%%%%.%.%%%%%%%...%%.%
%.%%.%%%%.%.%%%%%%%...%%.%
%.....................%%.%
%.%%.%%%%.%.%%%%%%%...%%.%
%........................%
%................%%...%%.%
%.%%.%%%%%%..%%..%%...%%.%
%........................%
%.%%.%%%%%%..%%..%%...%%.%
%.%%.%%%%%%..%%..%%...%%.%
%.%%.%%%%%%..%%..%%...%%.%
%............%%..%%...%%.%
%.%%.%%%%%%..%%..%%...%%.%
%.%%.%%%%%%..%%..%%...%%.%
%.%%.%%%%%%..%%..%%...%%.%
%.....................%%.%
%.%%.%%%%%%..%%..%%...%%.%
%P.G.....................%
%.%%.%%%%%%%%%%%.%%...%%.%
%.%%.%%%%%%%%%%%.%%...%%.%
%o..G...................o%
%%%%%%%%%%%%%%%%%%%%%%%%%%
