%%%%%%%%%%%%%%%%%%%%%%%
%%%%%%%%o.........G..o%
%%%%%%%%%%.........%..%
%%%%%%.......%%....G..%
%%%%%%%%..............%
%%%%%%.......%........%
%%%%%%%...............%
%%%%%%%..%%...........%
%%%%%%%..%%...........%
%%%%%%%...............%
%%%%%%%..%%...........%
%.....................%
%.%..G..........%..%..%
%.%.%.................%
%.%.%...%%%...%....%..%
%.%.%.....%...........%
%.........P........%%.%
%.............%%...%%.%
%o.G.................o%
%%%%%%%%%%%%%%%%%%%%%%%
