%%%%%%%%%%%%%%%%%%%%%
%%%%o..............o%
%%%%..........G.....%
%%%%...%.%.....%.%%.%
%%....P........%..%.%
%%%......%..........%
%......%.%.%..%%..%.%
%%%.................%
%.............%%....%
%...........G.....%.%
%%%.................%
%...................%
%%%.%%...G.....%%.%.%
%%%%%%.%.......%%...%
%%%%%%.%............%
%%%%%%%%.%..........%
%%%%%...............%
%%%%%.%.....%..%%...%
%%%%%.%%............%
%%%%%.%%..%%%.......%
%%%%%o...G.........o%
%%%%%%%%%%%%%%%%%%%%%
