%%%%%%%%%%%%%%%%%%%%%%%
%o...................o%
%.....................%
%..%%%.%%%%..%.%%%%%%.%
%..%%%.%%%%..%.%%%%%%.%
%..%%%.%%%%..%.%%%%...%
%..%%%.%%%%..%.%%%%%%.%
%...............G.....%
%..%%%.%%%%..%.%%%%%%.%
%..%%%.%%%%..%........%
%..%%%.%%%%..%%%%.....%
%..%%%.%%%%P..........%
%..G..................%
%..%%%................%
%..%%%.%%%%%%%.%%.%%%.%
%..%%%.%%%%%%%.%%.%%%.%
%..%%%................%
%..%%%.%%%%%%%.%%.%%%.%
%..%%%.........%%.%%%.%
%..%%%................%
%.....................%
%o...................o%
%%%%%%%%%%%%%%%%%%%%%%%
