%%%%%%%%%%%%%%%%%%%%%%%
%o...................o%
%...........%..%%%%%%.%
%..%%%.%%%..%..%%%%%%.%
%..%%%.%%%..%..%%%%%%.%
%..%%%......%..%%%%%%.%
%..%%%................%
%..%%%.%%%..%..%%%%%%.%
%..%%%.%%%..%..%%%%%%.%
%.....................%
%..%%%.%%%..%.........%
%.....................%
%...........%..%%%%%%.%
%..%%%.%%%..%..%%%%%%.%
%..%%%.%%%..%..%%%%%%.%
%..%%%.%%%..%..%%%%%%.%
%..%%%.%%%..%.%%%%%%%.%
%..%%%.%%%..%.%%%%%%%.%
%..%%%.%%%..%.%%%%%%%.%
%..................G..%
%..%%%.%%...%.%%%%%%%.%
%...........%.....P...%
%o................G..o%
%%%%%%%%%%%%%%%%%%%%%%%
