%%%%%%%%%%%%%%%%%%%%%%
%o..................o%
%.%%%.%%.%.%.%.%%....%
%......%.%.%.........%
%.%%%..%.%.P......%%.%
%.%%%........%.%%.%%.%
%.%%%..............%.%
%.%%%..%.%...........%
%....................%
%.%....%%............%
%.%%%..%%.....G......%
%.%%%.%%.............%
%.%%%.......%...%..%.%
%...........G........%
%.%%%.%%...........%.%
%...%.%%.............%
%...%.%%.............%
%...........%..%%%.%.%
%...%..%%...%........%
%.............%%%%.%.%
%..%%..%%G%%%%%%%%.%.%
%o.......G%%%%%%%%.%o%
%%%%%%%%%%%%%%%%%%%%%%
