%%%%%%%%%%%%%%%%%%%%%
%%%%%%%%o........Po%%
%%%%%%%%.%..........%
%%%%%%.%............%
%.%%%%..........%%..%
%............%.%%%%.%
%.%%%%.%%....%.%....%
%...................%
%.%%..%%%...........%
%.%%..%%%......%%.%.%
%.%............%%...%
%.%..%%%..G....%%.%.%
%...................%
%.....%%.......%%.%.%
%............G......%
%%%%............%.%.%
%%%%................%
%%%%..%%....G.....%.%
%%%G.........%..%.%.%
%%%o...............o%
%%%%%%%%%%%%%%%%%%%%%
