%%%%%%%%%%%%%%%%%%%%
%o....G......o%%%%%%
%%%%.%%%...%%.%%%%%%
%%.........%%.%%%%%%
%%%%.%.%......%%%%%%
%..................%
%.%%%%.....%%%%%%%.%
%.%........%%%%%%%.%
%..................%
%...............%%.%
%...%....%.%.%.....%
%..................%
%...%...%..%.%%..%.%
%..........%.....%.%
%..%.............%.%
%..%......%%.......%
%.........%%....%%%%
%G.%............%%%%
%.........%%..P...%%
%..%%.....%%....%.%%
%.....GG........%.%%
%o................o%
%%%%%%%%%%%%%%%%%%%%
