%%%%%%%%%%
%o......o%
%.%%.%%%.%
%.%%.%.%.%
%.%%%%.%.%
%.%%%%.%.%
%.%%%....%
%.%%%%.%G%
%.%%%%P%.%
%..G.....%
%........%
%%%%%%%%%%
