%%%%%%%%%%%%%
%..........o%
%.%%%%%.%%%.%
%.G.........%
%..%%%%.%%%.%
%.....%.%%%.%
%...........%
%PG%%%%%%%%.%
%...%%.%%%%.%
%...%%.%%%%.%
%..........o%
%%%%%%%%%%%%%
