%%%%%%%%%%%%%%%%
%o........G....%
%.%%%%.%%%%.%..%
%.%%%%.%%%%.%..%
%.%%%.......%..%
%...........%..%
%.%%%.%%%%%....%
%.%%%.%%%%%%%..%
%.%%%.%%%%%%%..%
%.........P....%
%.............G%
%.%%%%%%%%.....%
%.%%%%%%%%.%%..%
%.%%%%%%%%.%...%
%.............o%
%%%%%%%%%%%%%%%%
