%%%%%%%%%
%o...G.o%
%....%..%
%...%%..%
%%..%%..%
%%...GG.%
%%P.....%
%%...%.%%
%%.%.%.%%
%......G%
%%%%%%%%%
