%%%%%%%%%
%P.....o%
%.......%
%.%%%...%
%..G...G%
%G%%.%.%%
%.%%.%.%%
%.%%...%%
%G.....o%
%%%%%%%%%
