%%%%%%%%
%.GG..o%
%.%...G%
%......%
%.G....%
%.%%%%.%
%.%%%%.%
%P%....%
%.%.%%.%
%o.....%
%%%%%%%%
