%%%%%%%%%%
%o.......%
%.%.%%%..%
%.....P..%
%...%%%..%
%...%%...%
%...%%%%.%
%.G..GGGo%
%%%%%%%%%%
