%%%%%%%%%%
%.......%%
%.%.%.%.%%
%.......%%
%.%.%.%.%%
%.......%%
%G%.%.%.%%
%.%.%.%.%%
%.%.%.%.%%
%..G....%%
%%%%%%%.%%
%%%%%%%P%%
%%%%%%%.%%
%o.....o%%
%%%%%%%%%%
%%%%%%%%%%
