%%%%%%%%%%
%oP.G....%
%........%
%..%%.%%.%
%.....%%.%
%......G.%
%%.%%.%%%%
%%.%%.%%%%
%%.%%o%%%%
%%%%%%%%%%
