%%%%%%%%%%%%%%%
%.............%
%.%%.%%%.%%%%.%
%........%%%%.%
%...........%.%
%..%.%%%%%%%%.%
%..%.....%%%%.%
%......P......%
%..%.%%%%%%%%.%
%G.%.%%.%%%%%.%
%.%%.%%.%%%%%.%
%o..........Go%
%%%%%%%%%%%%%%%
