%%%%%%%%%%
%%%%%o%%%%
%%%%%.%%%%
%.%GG...%%
%.%.%.%.%%
%.......%%
%.%.%.%.%%
%.......%%
%.%P%.%.%%
%.%.%.%.%%
%.%.%.%.%%
%o......%%
%%%%%%%%%%
%%%%%%%%%%
