%%%%%%%%%%
%.....Po%%
%.%.%%%.%%
%.......%%
%%%.%%%.%%
%%%...%.%%
%%%.%.%.%%
%%%G%.%.%%
%%%.%.%.%%
%%%o..G.%%
%%%%%%%%%%
