%%%%%%%%%%
%o.......%
%P.%%%...%
%..%%%...%
%......G.%
%.%%%%..G%
%.%%%%...%
%.....GGo%
%%%%%%%%%%
