%%%%%%%%%
%o.GG...%
%P......%
%..%%.%.%
%..%%.%.%
%...GG..%
%..%%.%.%
%......o%
%%%%%%%%%
