%%%%%%%%%%
%%%%%%%%%%
%o....G..%
%...%.%%.%
%G..%G%%.%
%........%
%........%
%.....%..%
%oP.....G%
%%%%%%%%%%
