%%%%%%%%%
%o......%
%.......%
%.P.%%..%
%.......%
%..%%%..%
%..%%%G.%
%..G....%
%..%%%..%
%G.%%%..%
%oG.....%
%%%%%%%%%
