%%%%%%%%%%
%.GG....o%
%.....%G.%
%.%.%.%..%
%.%..P%..%
%.%.%%%..%
%G......o%
%%%%%%%%%%
