%%%%%%%%%%%
%o......%%%
%.%.....G.%
%.%%%%...%%
%.%%%....%%
%..G...P..%
%.%%%.%...%
%.G.......%
%.......Go%
%%%%%%%%%%%
