%%%%%%%%%%%%
%..........%
%G%%..%%.%.%
%.%%.......%
%G.....P.%.%
%.G....%.%.%
%.%......G.%
%.%%.%.%%%.%
%o%%.....%o%
%%%%%%%%%%%%
