%%%%%%%%%%%%%%
%o.........%%%
%............%
%.%.....%%%%.%
%...%%%.%%%%.%
%.%%%%%.%%%%.%
%.%%%%%.%.%%.%
%.%%%%%.%.%%.%
%..........%.%
%.P........%.%
%.%%%%%.%..%G%
%.%%%%%.%%.%.%
%o.........G.%
%%%%%%%%%%%%%%
