%%%%%%%%%
%%%o%.Go%
%.......%
%%%.....%
%.G...P.%
%G%.%%%.%
%......G%
%%%%%%%%%
