%%%%%%%%%%%%%
%%%%%%%%%%%%%
%%..P......%%
%%.%.%.%.%.%%
%%.........%%
%%.%.%.%.%.%%
%%.%.%.%.%G%%
%%G%.%.%.%.%%
%%.%.%.%.%.%%
%%.%.%.%.%.%%
%%o....%..o%%
%%%%%%%%%%%%%
