%%%%%%%%%%%%%%%%
%.....P......o%%
%.%.%.%.%.%.%.%%
%.%.%.%.%.%...%%
%%%.%.%.%.%%%.%%
%%%.%...%.%%%.%%
%%%.%.%.%.%%%.%%
%oG.G.........%%
%%%%%%%%%%%%%%%%
%%%%%%%%%%%%%%%%
