%%%%%%%%%
%o...%%o%
%...G...%
%....%%%%
%....%%%%
%.P..%%%%
%.......%
%..%.%%G%
%..GG...%
%%%%%%%%%
