%%%%%%%%%%%%
%..........%
%P%%.%.%%.%%
%.%....%%.%%
%.%%.%.%%.%%
%.%%.%.%%..%
%...G%.%%..%
%.%%.......%
%%%%..%%%%.%
%..........%
%.%%.%%%%%.%
%.%%.%%%%%.%
%oG.......o%
%%%%%%%%%%%%
