%%%%%%%%%%
%o..G....%
%.......%%
%G.......%
%%%..P%%.%
%%%...%%.%
%.%...%%.%
%G%...%%.%
%oG......%
%%%%%%%%%%
