%%%%%%%%%%
%o.......%
%........%
%.%%..%%.%
%.%%..%%.%
%.%%..%%.%
%P%%%.%%.%
%.%......%
%.%%%GG..%
%.%%%.%%.%
%.%%%....%
%.%%%.%%o%
%%%%%%%%%%
