%%%%%%%%%%%
%%%%.....o%
%%%%.%.%%.%
%%%%..P%%.%
%%%%.%....%
%.......G.%
%.%%.%....%
%.%%......%
%.%%G.....%
%.%%.%%%%%%
%....o%%%%%
%%%%%%%%%%%
