%%%%%%%%%%%%%%%%
%%%%%o.......Go%
%%%%%..........%
%%%%%..%%%%%...%
%%%%%......%...%
%%%............%
%%%%%...%%%%.G.%
%%%%%...%%%%...%
%%%%%...%%%.P..%
%%%%%..........%
%..............%
%%%%%%%%%%%%%%%%
