%%%%%%%%
%o%%.%.%
%P.....%
%.%..G.%
%......%
%.%%%GG%
%.%%%..%
%..G..o%
%%%%%%%%
