%%%%%%%%%%%%%
%oG........o%
%%%.%.%P%%%.%
%.....%.%%%.%
%%%.%.%.%%%.%
%%%.%.%.%...%
%%%.%.%.%%%.%
%...%.%.%%%.%
%.%.%.%.%%%%%
%G..........%
%%%%%%%%%%%%%
%%%%%%%%%%%%%
