%%%%%%%%%
%o.G.G.%%
%......%%
%.GG....%
%..%.%%%%
%..%.%%%%
%...P..o%
%%%%%%%%%
