%%%%%%%%%%%%%%%
%o.........o%%%
%.%.%.%.%%%.%%%
%...%.%.%%%.%%%
%.%.%.%.%%%.%%%
%.%.%.%.P.....%
%G%G%.%.%%%.%%%
%.........%.%%%
%%%%%%%%%%%%%%%
%%%%%%%%%%%%%%%
