%%%%%%%%%%%%%%%%
%%%%%%%%%%%%%%%%
%%o..........Po%
%%.%.%%%.%.%.%.%
%%.%.%%%.%.%...%
%%.%.%%%.%.%.%.%
%%.%.%%%.%.%.%.%
%%.%.%%%.%.%.%.%
%%.............%
%%.%.%%%.%.%.%.%
%%.%.........%G%
%%.%%%%%.%.%.%.%
%%.......%.%...%
%%G%%%%%.%.%%%.%
%%............o%
%%%%%%%%%%%%%%%%
