%%%%%%%%%%%%%%%%
%.............o%
%..%..%...%.%%.%
%..............%
%.....%...%.%%.%
%.........%.%%.%
%............GG%
%...G....G.%%%.%
%........%.%%%%%
%........%.%%%%%
%.....%%%%.%%..%
%.....%%%%.....%
%......%%%%%%..%
%.%...%%%%%%%..%
%o........P...o%
%%%%%%%%%%%%%%%%
