%%%%%%%%%%%%%%%%%%%%%
%oP.......G........o%
%.%%%%.%%%.%%.%.%%..%
%.%%%%.%%%.%%.......%
%.%.%%..............%
%.%.%%..........%%..%
%.%.%%..%%.%%.%%%%..%
%.%.%%..............%
%.%.%%%.%%.%%.%%%%..%
%G%.%%%.%%.%%.%%%%..%
%%%.%%%.%%.%%.%%%%..%
%%%.%%%.%%.%%.%%%%..%
%%%.%%%.%%.%%.%%%%..%
%%%.................%
%%%.%%%.%%.%%%%%%%..%
%...................%
%...................%
%..................o%
%%%%%%%%%%%%%%%%%%%%%
