%%%%%%%%%%%%%%%%%%%%
%%%%%%%%%%%%%%%%%%%%
%%o...............o%
%%.%%%.%%%.%.%%%.%.%
%%.................%
%%.%%%%%%%.%.%%%.%.%
%%.G...............%
%%.%.%%%%%.%.%%%.%.%
%%.................%
%%.%.%%%%%.%.%%%.%.%
%%.........%.%%%.%.%
%%.%.%%%%%.%.%%%.%.%
%%.%.%%%%%.%.......%
%%.%.%%%%%.%%%%%G%.%
%%.%.%%%%%.%%%%%.%.%
%%.%.%%%%%.%%%%%.%.%
%%.......P........o%
%%%%%%%%%%%%%%%%%%%%
