%%%%%%%%%%%%%%%
%o.GG.%.%%G.Go%
%.%%%.%.%%.%..%
%.%%%.%.%%.%..%
%.%%%.%.%%.%..%
%.%%%.%.......%
%........%.%..%
%.....%.......%
%........%....%
%.%%%..%.%%%..%
%......%.%%...%
%.......P.....%
%........%%...%
%...%.........%
%o............%
%%%%%%%%%%%%%%%
