%%%%%%%%%%%%%%%%
%o%%%..........%
%.%%%.%%%......%
%.....%%%...%..%
%.......P......%
%.%%%.%%......G%
%.%%%..........%
%....G.........%
%%%%%.%%.%%....%
%........%%%...%
%.%.....G......%
%G%...%%%%%%...%
%o............o%
%%%%%%%%%%%%%%%%
