%%%%%%%%%%%%%%
%%%%%%o.P...o%
%%%%%%..%.%%.%
%%%%%%..%....%
%%%%%%.....%.%
%............%
%.%%..G...G..%
%..........%.%
%..%.........%
%....%.....%.%
%.........G%.%
%..........%.%
%o......%..G.%
%%%%%%%%%%%%%%
