%%%%%%%%%%%%%%%%
%o..%G....%....%
%...%.%%%.%.G%.%
%......%%.%..%.%
%............%.%
%............%.%
%.%.%%.%%....%.%
%.%.%%..P......%
%.%%...........%
%.%%.%..%...%%G%
%.%%.%..%%..%%.%
%.%%.%..%......%
%o.......G....o%
%%%%%%%%%%%%%%%%
