%%%%%%%%%%%%%%%%%%%
%%%%%%%%%%%%%%%%%%%
%%o..........GG.o%%
%%.%.%%%.%%%%%.%.%%
%%.%.%%%.%.%%%...%%
%%.%.%%%.%.%%%.%.%%
%%...............%%
%%.%.%%%.%.%%%.%.%%
%%.....P.......%.%%
%%.%.%%%.%%%.%.%.%%
%%...............%%
%%.%.%%%.%%%.%.%.%%
%%.%.............%%
%%.%%%%%.%%%.%.%.%%
%%o..............%%
%%%%%%%%%%%%%%%%%%%
%%%%%%%%%%%%%%%%%%%
