%%%%%%%%%%%%%%%%
%o%%%.......G.o%
%.%%%..%G.%%.%.%
%.%%%..%.......%
%..............%
%.%%...........%
%.%%.%.....%...%
%.%%.%%....%...%
%..P.......%.%.%
%.%%.%%%.......%
%......%%......%
%.....%%%...G..%
%..%%%%%%..%...%
%..........G..o%
%%%%%%%%%%%%%%%%
