%%%%%%%%%%%%%%%%
%o......%%%%%%o%
%.%%%%..%%%%%%.%
%.%%%%..%%%%%%.%
%....G.........%
%..........%%%.%
%.......%..%%%.%
%..%.....G.....%
%...G......%%%.%
%G.%..%.%......%
%..........%%..%
%..%..%%.....P.%
%..............%
%o.............%
%%%%%%%%%%%%%%%%
