%%%%%%%%%%%%%%%%
%...P.........o%
%.%.%%.%%%%%%..%
%.............G%
%.%.%%.%%%%%%..%
%.%.%%.%%%%%%..%
%.%.%%.%%%%%%..%
%...%%.%%%%%%..%
%.%.%%.%%%%%%..%
%..............%
%.%.%%G%%%%%%..%
%.%.%%.%%%%%%..%
%..............%
%.........%%...%
%.%.%%.%%%%%...%
%..............%
%..............%
%...%%%%%......%
%...%%%%%%%%...%
%.%%%%%%%%%%...%
%o............o%
%%%%%%%%%%%%%%%%
