%%%%%%%%%%%%%%%%%%%
%o...............o%
%.%%%%%%%%%%%%%.%.%
%.................%
%.%%%%%%%.%%%%%.%.%
%.%%%%%%%.%%%%%.%.%
%.%%%%%%%.%%%%%.%.%
%.................%
%.%%%%%%%.%%%%%.%.%
%.%%%%%%%.%%%%%.%.%
%.%%%%%%%.%%%%%.%G%
%.................%
%.%%%%%%%.%%%.%.%.%
%..........G%.%.%.%
%.%%%%%%%.%.%.%.%.%
%.%%%%%%%.%.%.%.%.%
%.%%%%%%%.%.%.%.%.%
%.................%
%.%%%%%%%.%.%%%.%.%
%oP...............%
%%%%%%%%%%%%%%%%%%%
%%%%%%%%%%%%%%%%%%%
