%%%%%%%%%%%%%%%
%o...........o%
%.......%%%%..%
%.............%
%.%.%..%%%%%%.%
%.%G%..%%%%%%.%
%...G...%%%%..%
%....%.%%%%%..%
%G.....%%%%%..%
%....%........%
%.G.........%.%
%...........%.%
%o.......P....%
%%%%%%%%%%%%%%%
