%%%%%%%%%%%%%%%%%%%%%%
%o.............P.....%
%.%%%%%.%.%.%%%%..%%.%
%.%%%%%.%.%.%%%%..%%.%
%.%%%%%.%.%.%%%%..%%.%
%.%%%%%.%.%.%%%%..%%.%
%.%%%%%.%.%.%%%%..%%.%
%.%%%%%.%.%.%%%%..%%.%
%............%%%..%%.%
%..................%.%
%.%%%%%.%..........%.%
%.%%%%%.%.%..%%%...%G%
%....................%
%.%%%%%.%.%..%.......%
%.%%%%%.%.%..%.%.%.%.%
%.%%%%%%%.%..%.......%
%.......%.%..%.%.%.%.%
%.%%%%%.%.%..%.%.%.%.%
%....................%
%.......%.%..%.%.%.%.%
%o....G.............o%
%%%%%%%%%%%%%%%%%%%%%%
