%%%%%%%%%%%%%%%%
%.%%%%%%.%%%..o%
%.%%%%%%.......%
%.%%%%%%..%%...%
%..............%
%............G.%
%..........%%..%
%..P.......%%..%
%..%.%...GG%%.%%
%.............%%
%........%.%%%%%
%....%.........%
%........%.%%..%
%oG...........o%
%%%%%%%%%%%%%%%%
