%%%%%%%%%%%%%%%%
%o............o%
%.%%.%%.%...%%.%
%.%%.%%.%...%%.%
%....%%.%...%%.%
%...........%%.%
%...........%%.%
%.%..%%%%..%%%.%
%..........%%%.%
%.%..%%%%..%%%.%
%.%..%%%%..%%%.%
%.....%%%..%%%.%
%.%..%%%%..%%%.%
%.%..%%%%..%%%.%
%..............%
%..........%%%.%
%.%..%%%%.%%%%.%
%.%..%%%%.%%%%.%
%.%GP%%%%.%%%%G%
%o...%%........%
%%%%%%%%%%%%%%%%
