%%%%%%%%%%%%%%
%o...........%
%..%%....P...%
%.........%%%%
%...%.%%..%%%%
%...%.%%..%%.%
%......%..%%.%
%...%%.%....G%
%G........%%.%
%...%..%...%.%
%............%
%...%......%%%
%GG.%......%%%
%o........o%%%
%%%%%%%%%%%%%%
