%%%%%%%%%%%%%%%%
%oG............%
%.......%%..%%.%
%.%%%%%.%%..P..%
%.%%...........%
%.%%%%.......%.%
%%%%%%%..G.%.%.%
%%%%%%%........%
%%%............%
%%%%.%%%.G.%G..%
%..............%
%..............%
%o............o%
%%%%%%%%%%%%%%%%
