%%%%%%%%%%%%%%%%%%%
%o.......G.......o%
%.%%%.%%%%%%%..%..%
%.................%
%.....%%.%%%%..%..%
%.%.%.%%.%%%%..%..%
%.%.%.%%.%%%%..%..%
%.%.%.%%.%%%%..%..%
%.%.%.%%.%%%%..%..%
%.%.%.%%.%%%%..%.P%
%.%.%.%%.%%%%..%%.%
%.................%
%.%.%.%%.%%%%..%%.%
%.%.%.%..%%%%..%%.%
%.%.%.%..%%%%..%%.%
%.%.%.%..%%%%.%%%.%
%........%%%%.%%%.%
%.%.%.............%
%.%.%%%%.%%%%.%%%.%
%.%...............%
%...............Go%
%%%%%%%%%%%%%%%%%%%
